dims: 13 13
rooms: 4
start: 1 1
goal: 11 11

xxxxxxxxxxxxx
x11111x22222x
x11111x22222x
x11111122222x
x11111x22222x
x11111x22222x
xx3xxxx22222x
x33333xxx2xxx
x33333x44444x
x33333x44444x
x33333444444x
x33333x44444x
xxxxxxxxxxxxx

