dims: 13 13
rooms: 4
start: 1 1
goal: 11 11

xxxxxxxxxxxxx
x00000x11111x
x00000x11111x
x00000011111x
x00000x11111x
x00000x11111x
xx2xxxx11111x
x22222xxx1xxx
x22222x33333x
x22222x33333x
x22222333333x
x22222x33333x
xxxxxxxxxxxxx

